0000000000
011110000G
0100000B01
0111BB0B01
0000000101
0111111101
00000001B1
1111110101
000000010B
011111110B
00000000x0